Unneeded Packages Installed Explicitly:
  acpi                      	 27.59 K - Client for battery, power, and thermal readings
  alacritty                 	  5.63 M - A cross-platform, GPU-accelerated terminal emulator
 *aspell                    	  3.31 M - A spell checker designed to eventually replace Ispell
 *atool                     	 83.80 K - A script for managing file archives of various types
 *automake                  	  1.57 M - A GNU tool for automatically creating Makefiles (base-devel)
  autorandr                 	 86.44 K - Auto-detect connected display hardware and load appropiate X11 setup using xrandr
  base                      	  1.52 M - Minimal package set to define a basic Arch Linux installation
 *bash-completion           	851.13 K - Programmable completion for the bash shell
 *bat                       	  4.50 M - Cat clone with syntax highlighting and git integration
  batsignal                 	 23.64 K - A lightweight battery monitor daemon
  battop                    	  1.22 M - Interactive batteries viewer
  bison                     	  2.53 M - The GNU general-purpose parser generator (base-devel)
  blueman                   	  4.10 M - GTK+ Bluetooth Manager
  bluez-utils-compat        	  9.60 M - Development and debugging utilities for the bluetooth protocol stack. Includes deprecated tools.
  cbatticon                 	115.92 K - Lightweight battery icon for the system tray
  cherrytree                	 10.77 M - Hierarchical note-taking application
  clight-git                	371.50 K - A C daemon that turns your webcam into a light sensor. It can also change display gamma temperature, dim your screen and set your dpms.
  conky                     	  4.46 M - Lightweight system monitor for X
  cronie                    	218.23 K - Daemon that runs specified programs at scheduled times and related tools
  cups                      	 12.72 M - The CUPS Printing System - daemon package
  dconf-editor              	  2.86 M - dconf Editor (gnome-extra)
  dex                       	 31.57 K - Program to generate and execute DesktopEntry files of type Application
  dmenu                     	 51.36 K - Generic menu for X
  docker-compose            	 27.43 M - Fast, isolated development environments using Docker
  dotnet-sdk                	276.60 M - The .NET Core SDK
  dpkg                      	  8.23 M - The Debian Package Manager tools
  dragon-drop-git           	 26.44 K - Simple drag-and-drop source/sink for X or Wayland
  dunst                     	248.21 K - Customizable and lightweight notification-daemon
 *efibootmgr                	642.02 K - Linux user-space application to modify the EFI Boot Manager
  electron                  	181.86 M - Build cross platform desktop apps with web technologies
 *elinks                    	  3.39 M - An advanced and well-established feature-rich text mode web browser.
  emacs                     	118.64 M - The extensible, customizable, self-documenting real-time display editor
  evtest                    	 59.59 K - Input device event monitor and query tool
  exa                       	854.40 K - ls replacement
  fakeroot                  	134.23 K - Tool for simulating superuser privileges (base-devel)
  fdupes                    	 76.58 K - a program for identifying or deleting duplicate files residing within specified directories
  featherpad                	  3.55 M - Lightweight Qt plain text editor
 *feh                       	441.38 K - Fast and light imlib2-based image viewer
  figlet-fonts              	  4.16 M - Additional asciiart fonts for figlet
  figlet-fonts-extra        	  3.93 M - Additional collection of asciiart fonts for figlet
  firefox                   	233.82 M - Standalone web browser from mozilla.org
 *fish                      	 15.27 M - Smart and user friendly shell intended mostly for interactive use
  flameshot                 	  2.03 M - Powerful yet simple to use screenshot software
  flex                      	971.00 K - A tool for generating text-scanning programs (base-devel)
  fontforge                 	 33.22 M - Outline and bitmap font editor
  fontpreview               	279.44 K - Highly customizable and minimal font previewer written in bash
  fontpreview-ueberzug-git  	  5.30 M - Preview system fonts in the terminal
 *freetds                   	 11.89 M - Library for accessing Sybase and MS SQL Server databases
  gi-docgen                 	  2.08 M - Documentation generator for GObject-based libraries
  gimp                      	113.04 M - GNU Image Manipulation Program
  gnome-common              	169.94 K - Common development macros for GNOME
  go                        	409.08 M - Core compiler tools for the Go programming language
  google-chrome             	264.33 M - The popular and trusted web browser by Google (Stable Channel)
  gparted                   	  7.18 M - A Partition Magic clone, frontend to GNU Parted
  gpick                     	  1.11 M - Advanced color picker written in C++ using GTK+ toolkit
  grub                      	 32.88 M - GNU GRand Unified Bootloader (2)
 *gst-libav                 	234.48 K - Multimedia graph framework - libav plugin
 *gst-plugins-ugly          	714.19 K - Multimedia graph framework - ugly plugins
  gtk-engine-murrine        	312.15 K - GTK2 engine to make your desktop look like a 'murrina', an italian word meaning the art glass works done by Venicians glass blowers.
  gtk2fontsel               	 13.94 K - Font selection and preview tool
  gtksourceviewmm-docs      	 11.65 M - Developer documentation for gtksourceviewmm
 *hacksaw                   	778.18 K - Lightweight selection tool for usage in screenshot scripts etc.
  hdparm                    	186.17 K - A shell utility for manipulating Linux IDE drive/driver parameters
 *highlight                 	  3.12 M - Fast and flexible source code highlighter (CLI version)
 *hspell                    	771.06 K - Hebrew spell-checker
  htop                      	362.45 K - Interactive process viewer
  icon-naming-utils         	 38.39 K - Maps the new names of icons for Tango to the legacy names used by the GNOME and KDE desktops.
  idesk                     	266.57 K - gives users of minimal wm's (fluxbox, blackbox, openbox, windowmaker...) icons on their desktop
 *imagemagick-doc           	 10.65 M - An image viewing/manipulation program (manual and API docs)
  imwheel                   	 94.69 K - Mouse wheel configuration tool for XFree86/Xorg
  inkscape                  	162.71 M - Professional vector graphics editor
  intel-gpu-tools           	 14.35 M - Tools for development and testing of the Intel DRM driver
 *intel-media-driver        	 34.37 M - Intel Media Driver for VAAPI â€” Broadwell+ iGPUs
  intel-ucode               	  4.94 M - Microcode update files for Intel CPUs
  joshuto-git               	  3.30 M - ranger-like terminal file manager written in Rust
 *jpegexiforient            	 21.22 K - Get and set the Exif Orientation Tag
  kate                      	 26.85 M - Advanced Text Editor (kde-applications kde-utilities)
  kdesu                     	916.47 K - Integration with su for elevated privileges (kf5)
  kitty                     	 22.38 M - A modern, hackable, featureful, OpenGL-based terminal emulator
  lazygit                   	 13.84 M - Simple terminal UI for git commands
  leafpad                   	301.03 K - A notepad clone for GTK+ 2.0
  lib32-vulkan-intel        	 53.89 M - Intel's Vulkan mesa driver (32-bit)
 *libdvdnav                 	159.66 K - The library for xine-dvdnav plugin.
 *libfbclient               	  4.63 M - Client library for Firebird
  libfm                     	  4.13 M - Library for file management
  libgnome-keyring          	  1.13 M - GNOME keyring client library (deprecated)
  libgtop                   	  1.25 M - A library for collecting system monitoring data
  libibus                   	 93.39 M - IBus support library
 *libva-intel-driver        	  7.79 M - VA-API implementation for Intel G45 and HD Graphics family
  libvdpau-va-gl            	321.95 K - VDPAU driver with OpenGL/VAAPI backend
  libvips                   	  9.15 M - A fast image processing library with low memory needs
 *libvoikko                 	444.73 K - A spelling and grammar checker, hyphenator and collection of related linguistic data for Finnish language
  libwnck3                  	  3.08 M - Library to manage X windows and workspaces (via pagers, tasklists, etc.)
  libxml++-docs             	  3.89 M - C++ bindings to libxml2 (documentation)
 *linux                     	175.47 M - The Linux kernel and modules
 *linux-firmware            	165.76 M - Firmware files for Linux
  lostfiles                 	  8.41 K - Find orphaned files not owned by any Arch packages
  lsscsi                    	 92.89 K - A tool that lists devices connected via SCSI and its transports
  lxappearance              	395.29 K - Feature-rich GTK+ theme switcher of the LXDE Desktop (lxde)
 *lynx                      	  4.99 M - A text browser for the World Wide Web
 *mariadb-libs              	 22.64 M - MariaDB libraries
 *mediainfo                 	  9.03 M - Supplies technical and tag information about a video or audio file (CLI interface)
  meld                      	  3.77 M - Compare files, directories and working copies
  miniconda3                	371.81 M - Mini version of Anaconda Python distribution
  neofetch                  	339.13 K - A CLI system information tool written in BASH that supports displaying images.
  neovim                    	 35.65 M - Fork of Vim aiming to improve user experience, plugins, and GUIs
  nerd-fonts-liberation-mono	 27.04 M - Patched font Liberation Mono from the nerd-fonts library (nerd-fonts)
  network-manager-applet    	  1.04 M - Applet for managing network connections
 *nitrogen                  	455.08 K - Background browser and setter for X windows
  notepadqq                 	  5.39 M - Notepad++-like text editor for Linux
 *npm                       	  6.05 M - A package manager for javascript
 *odt2txt                   	466.63 K - extracts the text out of OpenDocument Texts
  openssl-1.0               	  5.82 M - The Open Source toolkit for Secure Sockets Layer and Transport Layer Security
 *p7zip                     	 11.21 M - Command-line file archiver with high compression ratio
  pacutils                  	490.27 K - Helper tools for libalpm
  paru                      	  7.61 M - Feature packed AUR helper
  picom                     	619.95 K - X compositor that may fix tearing issues
 *postgresql-libs           	  6.89 M - Libraries for use with PostgreSQL
  powertop                  	630.04 K - A tool to diagnose issues with power consumption and power management
  progress                  	 32.04 K - Shows running coreutils basic commands and displays stats
 *protobuf                  	  8.69 M - Protocol Buffers - Google's data interchange format
 *psutils                   	 71.12 K - A set of postscript utilities
 *pulseaudio                	  6.80 M - A featureful, general-purpose sound server
  pv                        	107.19 K - A terminal-based tool for monitoring the progress of data through a pipeline.
  python-future             	  3.86 M - Clean single-source support for Python 3 and 2
  python-icalendar          	550.98 K - A parser/generator of iCalendar files (RFC 2445)
  python-pdftotext          	 22.21 K - Simple PDF text extraction
 *python-pip                	 15.02 M - The PyPA recommended tool for installing Python packages
 *python-pyqt5              	 26.28 M - A set of Python bindings for the Qt5 toolkit (pyqt5)
  python-sqlalchemy         	 10.96 M - Python SQL toolkit and Object Relational Mapper
  python-virtualenv         	  6.82 M - Virtual Python Environment builder
  python-xapp               	106.26 K - Python Xapp Library
  python2                   	 76.84 M - A high-level scripting language
  qt5-styleplugins          	  1.14 M - Additional style plugins for Qt5
 *qt5-tools                 	 15.55 M - A cross-platform application and UI framework (Development Tools, QtHelp) (qt qt5)
  qt5-webengine             	151.46 M - Provides support for web applications using the Chromium browser project (qt qt5)
 *qt5-websockets            	299.11 K - Provides WebSocket communication compliant with RFC 6455 (qt qt5)
  qt5ct                     	861.48 K - Qt5 Configuration Utility
  qtcreator                 	108.58 M - Lightweight, cross-platform integrated development environment
  qtermwidget               	727.74 K - A terminal widget for Qt, used by QTerminal
  ranger                    	  1.82 M - Simple, vim-like file manager
  redshift                  	849.84 K - Adjusts the color temperature of your screen according to your surroundings.
  ripgrep                   	  4.42 M - A search tool that combines the usability of ag with the raw speed of grep
  rsync                     	592.66 K - A fast and versatile file copying tool for remote and local files
 *rust                      	521.97 M - Systems programming language focused on safety, speed and concurrency
  rxvt-unicode              	  3.12 M - Unicode enabled rxvt-clone terminal emulator (urxvt)
  sassc                     	 19.56 K - C implementation of Sass CSS preprocessor.
  scrot                     	542.41 K - Simple command-line screenshot utility for X
  shotgun                   	530.26 K - Minimal X screenshot utility
  spacefm-git               	  4.83 M - Multi-panel tabbed file manager
 *strace                    	  1.82 M - A diagnostic, debugging and instructional userspace tracer
 *sudo                      	  6.98 M - Give certain users the ability to run some commands as root (base-devel)
  sxhkd                     	138.22 K - Simple X hotkey daemon
  thunderbird               	194.31 M - Standalone mail and news reader from mozilla.org
 *tmux                      	  1.05 M - A terminal multiplexer
  trayclock                 	 45.91 K - trayclock is a simple analog clock for the sys-tray
  tree                      	 85.53 K - A directory listing program displaying a depth indented list of files
 *unrar                     	296.98 K - The RAR uncompression program
 *unzip                     	311.46 K - For extracting and viewing files in .zip archives
  ventoy-bin                	 17.60 M - A new multiboot USB solution
 *vim                       	  4.63 M - Vi Improved, a highly configurable, improved version of the vi text editor
  virtualbox                	162.59 M - Powerful x86 virtualization for enterprise as well as home use
  vlc                       	 58.71 M - Multi-platform MPEG, VCD/DVD, and DivX player
  vokoscreen                	  2.84 M - Easy to use screencast creator
 *vulkan-intel              	  8.27 M - Intel's Vulkan mesa driver
 *w3m                       	  2.04 M - Text-based Web browser as well as pager
 *wget                      	  3.03 M - Network utility to retrieve files from the Web
  wmctrl                    	 45.32 K - Control your EWMH compliant window manager from command line
  xapp                      	  1.07 M - Common library for X-Apps project
  xarchiver                 	  1.43 M - GTK+ frontend to various command line archivers
 *xclip                     	 34.39 K - Command line interface to the X11 clipboard
  xcur2png                  	 26.99 K - Convert X cursors to PNG images
  xdg-user-dirs             	148.52 K - Manage user directories like ~/Desktop and ~/Music
  xdo                       	 24.44 K - Utility for performing actions on windows in X
  xf86-input-mtrack         	 93.98 K - An Xorg driver for multitouch trackpads and clickpads
  xinput-gui                	164.51 K - A simple GUI for Xorg's Xinput tool.
  xorg-font-utils           	  0.00 B - Transitional package depending on xorg font utilities
  xorg-meta                 	 35.81 M - Meta package for installing the xorg group
 *xorg-twm                  	199.89 K - Tab Window Manager for the X Window System
  xorg-xclock               	 55.43 K - X clock
  xorg-xinit                	 35.42 K - X.Org initialisation program
  xorg-xlsfonts             	 28.21 K - List available X fonts
 *xsel                      	 40.26 K - XSel is a command-line program for getting and setting the contents of the X selection
  xstdcmap                  	 16.13 K - A X standard colormap utility
 *xterm                     	  1.33 M - X Terminal Emulator
  yad                       	 80.54 M - A fork of zenity - display graphical dialogs from shell scripts or command line
  yajl                      	220.88 K - Yet Another JSON Library
  yarn                      	  5.08 M - Fast, reliable, and secure dependency management
  yq                        	 73.95 K - Command-line YAML, XML, TOML processor - jq wrapper for YAML/XML/TOML documents
  zram-generator            	770.02 K - Systemd unit generator for zram devices
 *zsh                       	  6.60 M - A very advanced and programmable command interpreter (shell) for UNIX
Unneeded Packages Installed As Dependencies:
 *cmake                  	 64.87 M - A cross-platform open-source make system
 *dbus-python            	  5.44 M - Python bindings for DBUS
 *dhclient               	  2.91 M - A standalone DHCP client from the dhcp package
 *dnsmasq                	823.35 K - Lightweight, easy to configure DNS forwarder and DHCP server
 *ell                    	637.52 K - Embedded Linux library
  gobject-introspection  	 14.85 M - Introspection system for GObject-based libraries
  libayatana-appindicator	577.67 K - Ayatana Application Indicators shared library
  meson                  	  8.09 M - High productivity build system
 *modemmanager           	 29.14 M - Mobile broadband modem management service
 *openresolv             	 60.77 K - resolv.conf management framework (resolvconf)
  perl-yaml              	100.34 K - Perl/CPAN Module YAML : YAML Aint Markup Language
  python-docutils        	  4.27 M - Set of tools for processing plaintext docs into formats such as HTML, XML, or LaTeX
  vala                   	 14.16 M - Compiler for the GObject type system
Unneeded Packages In A Dependency Cycle:
 *ruby       	 14.00 M - An object-oriented language for quick and easy programming
  ruby-irb   	509.35 K - Interactive Ruby command-line tool for REPL (Read Eval Print Loop).
  ruby-reline	262.29 K - Alternative GNU Readline or Editline implementation by pure Ruby.
  rubygems   	962.21 K - Package management framework for Ruby
Installed Packages Not In A Repository:
  batsignal                 	 23.64 K - A lightweight battery monitor daemon
  battop                    	  1.22 M - Interactive batteries viewer
  bluez-utils-compat        	  9.60 M - Development and debugging utilities for the bluetooth protocol stack. Includes deprecated tools.
  clight-git                	371.50 K - A C daemon that turns your webcam into a light sensor. It can also change display gamma temperature, dim your screen and set your dpms.
  clightd-git               	160.49 K - Bus interface to change screen brightness and capture frames from webcam.
  dotnet-runtime-5.0-bin    	 66.74 M - The .NET Core runtime version 5.0 (binary) - End of life
  dragon-drop-git           	 26.44 K - Simple drag-and-drop source/sink for X or Wayland
  figlet-fonts              	  4.16 M - Additional asciiart fonts for figlet
  figlet-fonts-extra        	  3.93 M - Additional collection of asciiart fonts for figlet
  fontpreview               	279.44 K - Highly customizable and minimal font previewer written in bash
  fontpreview-ueberzug-git  	  5.30 M - Preview system fonts in the terminal
  google-chrome             	264.33 M - The popular and trusted web browser by Google (Stable Channel)
  idesk                     	266.57 K - gives users of minimal wm's (fluxbox, blackbox, openbox, windowmaker...) icons on their desktop
  joshuto-git               	  3.30 M - ranger-like terminal file manager written in Rust
  libmodule                 	 48.67 K - C linux library to build simple and modular projects
 *librsvg-git               	 16.21 M - SVG rendering library
  miniconda3                	371.81 M - Mini version of Anaconda Python distribution
  nerd-fonts-liberation-mono	 27.04 M - Patched font Liberation Mono from the nerd-fonts library (nerd-fonts)
  paru                      	  7.61 M - Feature packed AUR helper
  qt5-styleplugins          	  1.14 M - Additional style plugins for Qt5
  spacefm-git               	  4.83 M - Multi-panel tabbed file manager
  trayclock                 	 45.91 K - trayclock is a simple analog clock for the sys-tray
  ventoy-bin                	 17.60 M - A new multiboot USB solution
  xf86-input-mtrack         	 93.98 K - An Xorg driver for multitouch trackpads and clickpads
  xinput-gui                	164.51 K - A simple GUI for Xorg's Xinput tool.
  xorg-font-utils           	  0.00 B - Transitional package depending on xorg font utilities
  xorg-meta                 	 35.81 M - Meta package for installing the xorg group
  xstdcmap                  	 16.13 K - A X standard colormap utility
Package Cache Size:
  /var/cache/pacman/pkg/ 2.01 G (22.45 M not installed)
